111111111111111
100C00E0000Y001
100000000000001
1C11000C0000001
100011000000001
100000011111111
100000000000P01
111111111111111
