11111111111111111111111111111111111111111111111111111111111111111111111111111111111
100000000111100000000111111000000000C0000000000011111111000000000Y000000111111100E1
1P00111000C0001111100000000000000001111110000000000C000000000011111110000000C000001
11111111111111111111111111111111111111111111111111111111111111111111111111111111111
