111111111111111
100C00E0000P001
100000000000001
1C11000C0000001
100011000000001
100000011111111
100000000000Y01
111111111111111
